21,21,21,21,21,21,21,21,21,21,21,21,21,21,21,21,21,21,21,21
21,21,21,21,21,21,21,21,21,21,21,21,21,21,21,21,21,21,21,21
21,21,21,21,21,21,21,21,21,21,21,21,21,21,21,21,21,21,21,21
13,13,13,13,13,13,13,13,13,13,13,13,13,13,13,13,13,13,13,13
23,23,23,23,23,23,23,23,23,23,23,23,23,23,23,23,23,23,23,23
33,33,33,33,33,33,33,33,33,33,33,33,33,33,33,33,33,33,33,33
00,01,02,00,01,02,00,01,02,00,01,02,00,01,02,00,01,02,00,01
00,01,02,00,01,02,00,01,02,00,01,02,00,01,02,00,01,02,00,01
00,01,02,00,01,02,00,01,02,00,01,02,00,01,02,00,01,02,00,01
00,01,02,00,01,02,00,01,02,00,01,02,00,01,02,00,01,02,00,01
00,01,02,00,01,02,00,01,02,00,01,02,00,01,02,00,01,02,00,01
00,01,02,00,01,02,00,01,02,00,01,02,00,01,02,00,01,02,00,01
21,21,21,21,21,21,21,21,21,21,21,21,21,21,21,21,21,21,21,21
21,21,21,21,21,21,21,21,21,21,21,21,21,21,21,21,21,21,21,21
21,21,21,21,21,21,21,21,21,21,21,21,21,21,21,21,21,21,21,21

0,0,0,0,0,0,0,0,0,0,0,0,0,0,0,0,0,0,0,0
0,0,0,0,0,0,0,0,0,0,0,0,0,0,0,0,0,0,0,0
0,0,0,0,0,0,0,0,0,0,0,0,0,0,0,0,0,0,0,0
0,0,0,0,0,0,0,0,0,0,0,0,0,0,0,0,0,0,0,0
0,0,0,0,0,0,0,0,0,0,0,0,0,0,0,0,0,0,0,0
1,1,1,1,1,1,1,1,1,1,1,1,1,1,1,1,1,1,1,1
0,0,0,0,0,0,0,0,0,0,0,0,0,0,0,0,0,0,0,0
0,0,0,0,0,0,0,0,0,0,0,0,0,0,0,0,0,0,0,0
0,0,0,0,0,0,0,0,0,0,0,0,0,0,0,0,0,0,0,0
0,0,0,0,0,0,0,0,0,0,0,0,0,0,0,0,0,0,0,0
0,0,0,0,0,0,0,0,0,0,0,0,0,0,0,0,0,0,0,0
0,0,0,0,0,0,0,0,0,0,0,0,0,0,0,0,0,0,0,0
1,1,1,1,1,1,1,1,1,1,1,1,1,1,1,1,1,1,1,1
0,0,0,0,0,0,0,0,0,0,0,0,0,0,0,0,0,0,0,0
0,0,0,0,0,0,0,0,0,0,0,0,0,0,0,0,0,0,0,0