21,21,21,21,21,21,21,21,21,21,21,21,21,21,21,21,21,21,21,21
21,21,21,21,21,21,21,21,21,21,21,21,21,21,21,21,21,21,21,21
21,21,21,21,21,21,21,21,21,21,21,21,21,21,21,21,21,21,21,21
21,21,21,21,13,13,13,13,13,13,13,13,13,13,13,13,21,21,21,21
21,21,21,21,23,23,23,23,23,23,23,23,23,23,23,23,21,21,21,21
21,21,21,21,33,33,33,33,33,33,33,33,33,33,33,33,21,21,21,21
21,21,21,21,00,01,02,00,01,02,00,01,02,00,01,02,21,21,21,21
21,21,21,21,00,01,02,00,01,02,00,01,02,00,01,02,21,21,21,21
21,21,21,21,00,01,02,00,01,02,00,01,02,00,01,02,21,21,21,21
21,21,21,21,00,01,02,00,01,02,00,01,02,00,01,02,21,21,21,21
21,21,21,21,00,01,02,00,01,02,00,01,02,00,01,02,21,21,21,21
21,21,21,21,00,01,02,00,01,02,00,01,02,00,01,02,21,21,21,21
21,21,21,21,21,21,21,21,21,21,21,21,21,21,21,21,21,21,21,21
21,21,21,21,21,21,21,21,21,21,21,21,21,21,21,21,21,21,21,21
21,21,21,21,21,21,21,21,21,21,21,21,21,21,21,21,21,21,21,21
