21,21,21,21,21,21,21,21,21,21,21,21,21,21,21,21,21,21,21,21
21,21,21,21,21,21,21,21,21,21,21,21,21,21,21,21,21,21,21,21
21,21,21,21,21,21,21,21,21,21,21,21,21,21,21,21,21,21,21,21
21,13,13,13,13,13,13,13,13,13,13,13,13,13,13,13,13,13,13,13
21,23,23,23,23,23,23,23,23,23,23,23,23,23,23,23,23,23,23,23
21,33,33,33,33,33,33,33,33,33,33,33,33,33,33,33,33,33,33,33
21,01,02,00,01,02,00,01,02,00,01,02,00,01,02,00,01,02,00,01
21,01,02,00,01,02,00,01,02,00,01,02,00,01,02,00,01,02,00,01
21,01,02,00,01,02,00,01,02,00,01,02,00,01,02,00,01,02,00,01
21,01,02,00,01,02,00,01,02,00,01,02,00,01,02,00,01,02,00,01
21,01,02,00,01,02,00,01,02,00,01,02,00,01,02,00,01,02,00,01
21,01,02,00,01,02,00,01,02,00,01,02,00,01,02,00,01,02,00,01
21,21,21,21,21,21,21,21,21,21,21,21,21,21,21,21,21,21,21,21
21,21,21,21,21,21,21,21,21,21,21,21,21,21,21,21,21,21,21,21
21,21,21,21,21,21,21,21,21,21,21,21,21,21,21,21,21,21,21,21

0,0,0,0,0,0,0,0,0,0,0,0,0,0,0,0,0,0,0,0
0,0,0,0,0,0,0,0,0,0,0,0,0,0,0,0,0,0,0,0
0,0,0,0,0,0,0,0,0,0,0,0,0,0,0,0,0,0,0,0
0,0,0,0,0,0,0,0,0,0,0,0,0,0,0,0,0,0,0,0
0,0,0,0,0,0,0,0,0,0,0,0,0,0,0,0,0,0,0,0
1,1,1,1,1,1,1,1,1,1,1,1,1,1,1,1,1,1,1,1
1,0,0,0,0,0,0,0,0,0,0,0,0,0,0,0,0,0,0,0
1,0,0,0,0,0,0,0,0,0,0,0,0,0,0,0,0,0,0,0
1,0,0,0,0,0,0,0,0,0,0,0,0,0,0,0,0,0,0,0
1,0,0,0,0,0,0,0,0,0,0,0,0,0,0,0,0,0,0,0
1,0,0,0,0,0,0,0,0,0,0,0,0,0,0,0,0,0,0,0
1,0,0,0,0,0,0,0,0,0,0,0,0,0,0,0,0,0,0,0
1,1,1,1,1,1,1,1,1,1,1,1,1,1,1,1,1,1,1,1
0,0,0,0,0,0,0,0,0,0,0,0,0,0,0,0,0,0,0,0
0,0,0,0,0,0,0,0,0,0,0,0,0,0,0,0,0,0,0,0